NO     img/wall1.xpm

SO      img/wall4.xpm

WE img/wall2.xpm

EA img/wall3.xpm


F  63,191,95
C 104,200,237





1111111111111111111111111111111111111111
     1111111110000000000000000001111111   
        1010110000011100000000000111111
11111111111110111000000100011111111
11111111000001111100N00010001
       1000001 100000001100011111111
    11110000111101000000000011111
11111111111111111100111111111
1111111111111111100111111111
10000000111100010000000001001
100000001  100110101010000001
100000001 1110000001110100001
111111111 1111111111111111111